1111111111111111111111111
11C10100000000000000011111
110101010P011111010101111
10001C0100000011011101111
11011111110111011011C0111
100000000C101C10C1C101
11111111111111111101011
1C00E00000000000000001
111111111111111111111111