111111111111
100000000E01
10000P000001
111111111111