111111111111
10C0000EE001
10000P000001
111111111111