111111111111
10C000000001
10000P000001
111111111111