111111111111
100C00000E01
1P0000P00001
111111111111