111111111111
100C00000E01
100000000001
111111111111