11111111111111
1QUIEReBOLSA?1
10000CP0000001
11111111111111