1111111111111111111111
11C1010000000000000001
110101010P011111010101
10001C0100000011011101
1011111110111011011C01
100000100C101C10C1C101
1111111111111111110101
1C00E01000000000000001
1111111111111111111111