11111111111111
100P00E10000C1
11111111111111