1111111111111111111111
11C1010000000000000001
1101M1010M011111010101
10001C01M000001101M101
1011111110111011011C01
100000000C1M1C1MC1C101
1111111111111111110101
1C00E000000000000000P1
1111111111111111111111