1111111111111111111111111111111111
1C000000C0000P0000000C0000C00000E1
1111111111111111111111111111111111