NO   ./sprites/01/NO.png
SO   ./sprites/01/SO.png
WE   ./sprites/01/WE.png
EA   ./sprites/01/EA.png

F 30,30,25
C 40,10,50
111111111111111111111111111111111111111111111111111111111111
101011111000001110111000111110000111111111111111100111111111
100000000101101110011011111001111111111111111111101111111111
1011011101011010001010000000W0111111111111111111000011111111
101101000001101011111011111001011111111111111111011011111111
110001010110001000000011001110000111111110000000000111111111
110111011001110011111010111001011111111111101111111111111111
100100011100000101011000110111000001111111101111111111111111
110001001101011100011011110111111101111111101111111111111111
101101100000010101011110011100000000000000001111111111111111
100001101111000001000111100001110110001000101111111111111111
111011101011101111010000111111111111111111101111111111111111
100111000000101110101110000000000000000001101111111111111111
101010011101101100100111101111111111111101101111111111111101
110100110101101010110000001101000011100000001111111111100101
100111000001100000001111100000111001101101111111111111101101
111001011110001011101111001100000011101100000000000000000001
111111111111111111111111111111111111111111111111111111111111