NO   ./sprites/02/NO.png
SO   ./sprites/02/SO.png
WE   ./sprites/02/WE.png
EA   ./sprites/02/EA.png

F 0,0,0
C 255,255,255

11111111111111111111111111111111  1111111 1
11000000000000000000000100001101  1000001101
1111111111111111101111011111111   1111111 1
                1010000111
                10111111111111111111111111111111111111111111
    11111111    100000000000000000000000000000000000000000001
    10101001    11111111111000000010000001111111111111111111
    10100001        11111110000001 1000001
    11111111        100000000000001000000111111111111111111
                    100000000000000000000000000000000000001
    1111111111111111111110000111111110111111111111111111001
    100000000000000000000000010000011011          100011101
    111111111111111111111100111101110001         1000000001
  111111111111111111111111001111011100011111111111111111111
11100000000000000000000000000000000000000000000000000000001
1110000000000000000000000E0000000000000000000000000000000001
11110000000000000000000000000000000000000000000000000000001
11111111111111111111111111111111111111111111111111111111111