NO   ./sprites/03/NO.png
SO   ./sprites/03/SO.png
WE   ./sprites/03/WE.png
EA   ./sprites/03/EA.png

F 150,0,0
C 120,120,0


11111111111111111111111111111111111111111111111111
10000000000000000000000000000000000000000000000001
10000000000000000000001111100000000000000000000001
10000000000000000000010010010000000000000000000001
10000000000000000000010111010000000000000000000001
10000000000000000000010000010000000000000000000001
100000000000000000000011D1100000000000000000000001
10000000000000000000000101000000000000000000000001
10000000000000000000111000111000000000000000000001
100000000000000000011000N0001100000000000000000001
100000000000000000110001D1000110000000000000000001
10000000000000000110000101000011000000000000000001
10000000000000001100011000110001100000000000000001
10000000000000011000011000110000110000000000000001
10000000000000111000000101000000011100000000000001
10000000000001110000000101000000001110000000000001
10000000000000111000000101000000111000000000000001
10000000000000001100000101000001100000000000000001
10000000000000000110000111000011000000000000000001
10000000000000000011000010000110000000000000000001
10000000000000000001100000001100000000000000000001
10000000000000000000110000011000000000000000000001
10000000000000000000011000110000000000000000000001
10000000000000000000001101100000000000000000000001
10000000000000000000000101000000000000000000000001
10000000000000000000000010000000000000000000000001
10000000000000000000000000000000000000000000000001
10000000000000000000000000000000000000000000000001
10000000000000000000000000000000000000000000000001
10000000000000000000000000000000000000000000000001
10000000000000000000000000000000000000000000000001
10000000000000000000000000000000000000000000000001
10000000000000000000000000000000000000000000000001
10000000000000000000000000000000000000000000000001
10000000000000000000000000000000000000000000000001
10000000000000000000000000000000000000000000000001
10000000000000000000000000000000000000000000000001
10000000000000000000000000000000000000000000000001
10000000000000000000000000000000000000000000000001
10000000000000000000000000000000000000000000000001
10000000000000000000000000000000000000000000000001
10000000000000000000000000000000000000000000000001
10000000000000000000000000000000000000000000000001
10000000000000000000000000000000000000000000000001
10000000000000000000000000000000000000000000000001
10000000000000000000000000000000000000000000000001
10000000000000000000000000000000000000000000000001
10000000000000000000000000000000000000000000000001
10000000000000000000000000000000000000000000000001
10000000000000000000000000000000000000000000000001
11111111111111111111111111111111111111111111111111