NO   ./sprites/04/NO.png
SO   ./sprites/04/SO.png
WE   ./sprites/04/WE.png
EA   ./sprites/04/EA.png

F 50,25,0
C 150,70,0

1111111111111111111111111111111111
1000000000000D00100D000000D0000D01
11111D1111111100000111111D111D1101
10000000000001110111000000000001D1
1E00000000000000000000000000000101
1111111111111111111111111111111111