NO   ./sprites/05/NO.png
SO   ./sprites/05/SO.png
WE   ./sprites/05/WE.png
EA   ./sprites/05/EA.png

F 230,230,250
C 200,200,250

111111111111111
110000000000011
100111010111001
100100010001001
100111010111001
100100010001001
100111010111001
110000000000011
1111111D1111111
      101
      101
      101
      101
      101
      101
     11011
     10001
     10N01
     10001
     11111