NO   ./sprites/01/NO.png
SO   ./sprites/01/SO.png
WE   ./sprites/01/WE.png
EA   ./sprites/01/EA.png

F 50,50,50
C 150,20,100

1111111111111111111111111111111111111111111111111111111111111111111111111111111111111111111111111111111111111111111111111111111
1000000000000000000000000000000000000000000000000000000000000000000000000000000000000000000000000000000000000000000000000000001
1000000000000000000000000000000000000000000000000000000000000000000000000000000000000000000000000000000000000000000000000000001
1000000000000000000000000000000000000000000000000000000000000000000000000000000000000000000000000000000000000000000000000000001
1000000000000000000000000000000000000000000000000000000000000000000000000000000000000000000000000000000000000000000000000000001
1000000000000000000000000000000000000000000000000000000000000000000000000100000000000000000000000000000000000000000000000000001
1000000000000000000000000000000000000000000000000000000000000000000000001010000000000000000000000000000000000000000000000000001
1000000000000000000000000000000000000000000000000000000000000000000000010001000000000000000000000000000000000000000000000000001
1000000000000000000000000000000000000000000000000000000000000000000000100000100000000000000000000000000000000000000000000000001
1000000000000000000000000000000000000000000000000000000000000000000001000000010000000000000000000000000000000000000000000000001
1000000000000000000000000000000000000000000000000000000000000000000010000000001000000000000000000000000000000000000000000000001
1000000000000000000000000000000000000000000000000000000000000000000100000000000100000000000000000000000000000000000000000000001
1000000000000000000000000000000000000000000000000000000000000000001000000000000010000000000000000000000000000000000000000000001
1000000000000000000000000000000000000000000000000000000000000000010000000000000001000000000000000000000000000000000000000000001
1000000000000000000000000000000000000000000000000000000000000000100000000000000000100000000000000000000000000000000000000000001
1000000000000000000000000000000000000000000000000000000000000001000000000000000000010000000000000000000000000000000000000000001
1000000000000000000000000000000000000000000000000000000000000010000000000000000000100000000000000000000000000000000000000000001
1000000000000000000000000000000000000000000000000000000000000100000000000000000001000000000000000000000000000000000000000000001
1000000000000000000000000000000000000000000000000000000000001000000000000000000010000000000000000000000000000000000000000000001
1000000000000000000000000000000000000000000000000000000000010000000000000000000100000000000000000000000000000000000000000000001
1000000000000000000000000000000000000000000000000000000000100000000000000000001000000000000000000000000000000000000000000000001
1000000000000000000000000000000000000000000000000000000001000000000000000000010000000000000000000000000000000000000000000000001
1000000000000000000000000000000000000000000000000000000010000000000000000000100000000000000000000000000000000000000000000000001
1000000000000000000000000000000000000000000000000000000100000000000000000001000000000000000000000000000000000000000000000000001
1000000000000000000000000000000000000000000000000000001000000000000000000010000000000000000000000000000000000000000000000000001
1000000000000000000000000000000000000000000000000000010000000000000000000100000000000000000001000000000000000000000000000000001
1000000000000000000000000000000000000000000000000000100000000000000000001000000000000000000010100000000000000000000000000000001
1000000000000000000000000000000000000000000000000001000000000000000000010000000000000000000100010000000000000000000000000000001
1000000000000000000000000000000000000000000000000010000000000000000000100000000000000000001000001000000000000000000000000000001
1000000000000000000000000000000000000000000000000100000000000000000001000000000000000000010000000100000000000000000000000000001
1000000000000000000000000000000000000000000000001000000000000000000010000000000000000000100000000010000000000000000000000000001
1000000000000000000000000000000000000000000000010000000000000000000100000000000000000001000000000001000000000000000000000000001
1000000000000000000000000000000000000000000000100000000000000000001000000000000000000010000000000000100000000000000000000000001
1000000000000000000000000000000000000000000001000000000000000000010000000000000000000100000000000000010000000000000000000000001
1000000000000000000000000000000000000000000010000000000000000000100000000000000000001000000000000000001000000000000000000000001
1000000000000000000000000000000000000000000100000000000000000001000000000000000000010000000000000000000100000000000000000000001
1000000000000000000000000000000000000000000010000000000000000000100000000000000000100000000000000000000010000000000000000000001
1000000000000000000000000000000000000000000001000000000000000000010000000000000001000000000000000000000001000000000000000000001
1000000000000000000000000000000000000000000000100000000000000000001000000000000010000000000000000000000000100000000000000000001
1000000000000000000000000000000000000000000000010000000000000000000100000000000100000000000000000000000000010000000000000000001
1000000000000000000000000000000000000000000000001000000000000000000010000000001000000000000000000000000000001000000000000000001
1000000000000000000000000000000000000000000000000100000000000000000001000000010000000000000000000000000000000100000000000000001
1000000000000000000000000000000000000000000000000010000000000000000000100000100000000000000000000000000000000010000000000000001
1000000000000000000000000000000000000000000000000001000000000000000000010001000000000000000000000000000000000001000000000000001
1000000000000000000000000000000000000000000000000000100000000000000000001010000000000000000000000000000000000000100000000000001
1000000000000000000000000000000001000000000000000000010000000000000000000100000000000000000001000000000000000000010000000000001
1000000000000000000000000000000010100000000000000000001000000000000000000000000000000000000010100000000000000000001000000000001
1000000000000000000000000000000100010000000000000000000100000000000000000000000000000000000100010000000000000000000100000000001
1000000000000000000000000000001000001000000000000000000010000000000000000000000000000000001000001000000000000000000010000000001
1000000000000000000000000000010000000100000000000000000001000000000000000000000000000000010000000100000000000000000001000000001
1000000000000000000000000000100000000010000000000000000000100000000000000000000000000000100000000010000000000000000000100000001
1000000000000000000000000001000000000001000000000000000000010000000000000000000000000001000000000001000000000000000000010000001
1000000000000000000000000010000000000000100000000000000000001000000000000000000000000010000000000000100000000000000000001000001
1000000000000000000000000100000000000000010000000000000000000100000000000000000000000100000000000000010000000000000000000100001
1000000000000000000000001000000000000000001000000000000000000010000000000000000000001000000000000000001000000000000000000010001
1000000000000000000000010000000000000000000100000000000000000001000000000N00000000010000000000000000000100000000000000000001001
1000000000000000000000001000000000000000000010000000000000000010000000000000000000001000000000000000000010000000000000000010001
1000000000000000000000000100000000000000000001000000000000000100000000000000000000000100000000000000000001000000000000000100001
1000000000000000000000000010000000000000000000100000000000001000000000000000000000000010000000000000000000100000000000001000001
1000000000000000000000000001000000000000000000010000000000010000000000000000000000000001000000000000000000010000000000010000001
1000000000000000000000000000100000000000000000001000000000100000000000000000000000000000100000000000000000001000000000100000001
1000000000000000000000000000010000000000000000000100000001000000000000000000000000000000010000000000000000000100000001000000001
1000000000000000000000000000001000000000000000000010000010000000000000000000000000000000001000000000000000000010000010000000001
1000000000000000000000000000000100000000000000000001000100000000000000000000000000000000000100000000000000000001000100000000001
1000000000000000000000000000000010000000000000000000101000000000000000000000000000000000000010000000000000000000101000000000001
1000000000000000000000000000000001000000000000000000010000000000000000000100000000000000000001000000000000000000010000000000001
1000000000000000000000000000000000100000000000000000000000000000000000001010000000000000000000100000000000000000000000000000001
1000000000000000000000000000000000010000000000000000000000000000000000010001000000000000000000010000000000000000000000000000001
1000000000000000000000000000000000001000000000000000000000000000000000100000100000000000000000001000000000000000000000000000001
1000000000000000000000000000000000000100000000000000000000000000000001000000010000000000000000000100000000000000000000000000001
1000000000000000000000000000000000000010000000000000000000000000000010000000001000000000000000000010000000000000000000000000001
1000000000000000000000000000000000000001000000000000000000000000000100000000000100000000000000000001000000000000000000000000001
1000000000000000000000000000000000000000100000000000000000000000001000000000000010000000000000000000100000000000000000000000001
1000000000000000000000000000000000000000010000000000000000000000010000000000000001000000000000000000010000000000000000000000001
1000000000000000000000000000000000000000001000000000000000000000100000000000000000100000000000000000001000000000000000000000001
1000000000000000000000000000000000000000000100000000000000000001000000000000000000010000000000000000000100000000000000000000001
1000000000000000000000000000000000000000000010000000000000000010000000000000000000100000000000000000001000000000000000000000001
1000000000000000000000000000000000000000000001000000000000000100000000000000000001000000000000000000010000000000000000000000001
1000000000000000000000000000000000000000000000100000000000001000000000000000000010000000000000000000100000000000000000000000001
1000000000000000000000000000000000000000000000010000000000010000000000000000000100000000000000000001000000000000000000000000001
1000000000000000000000000000000000000000000000001000000000100000000000000000001000000000000000000010000000000000000000000000001
1000000000000000000000000000000000000000000000000100000001000000000000000000010000000000000000000100000000000000000000000000001
1000000000000000000000000000000000000000000000000010000010000000000000000000100000000000000000001000000000000000000000000000001
1000000000000000000000000000000000000000000000000001000100000000000000000001000000000000000000010000000000000000000000000000001
1000000000000000000000000000000000000000000000000000101000000000000000000010000000000000000000100000000000000000000000000000001
1000000000000000000000000000000000000000000000000000010000000000000000000100000000000000000001000000000000000000000000000000001
1000000000000000000000000000000000000000000000000000000000000000000000001000000000000000000010000000000000000000000000000000001
1000000000000000000000000000000000000000000000000000000000000000000000010000000000000000000100000000000000000000000000000000001
1000000000000000000000000000000000000000000000000000000000000000000000100000000000000000001000000000000000000000000000000000001
1000000000000000000000000000000000000000000000000000000000000000000001000000000000000000010000000000000000000000000000000000001
1000000000000000000000000000000000000000000000000000000000000000000010000000000000000000100000000000000000000000000000000000001
1000000000000000000000000000000000000000000000000000000000000000000100000000000000000001000000000000000000000000000000000000001
1000000000000000000000000000000000000000000000000000000000000000001000000000000000000010000000000000000000000000000000000000001
1000000000000000000000000000000000000000000000000000000000000000010000000000000000000100000000000000000000000000000000000000001
1000000000000000000000000000000000000000000000000000000000000000100000000000000000001000000000000000000000000000000000000000001
1000000000000000000000000000000000000000000000000000000000000001000000000000000000010000000000000000000000000000000000000000001
1000000000000000000000000000000000000000000000000000000000000000100000000000000000100000000000000000000000000000000000000000001
1000000000000000000000000000000000000000000000000000000000000000010000000000000001000000000000000000000000000000000000000000001
1000000000000000000000000000000000000000000000000000000000000000001000000000000010000000000000000000000000000000000000000000001
1000000000000000000000000000000000000000000000000000000000000000000100000000000100000000000000000000000000000000000000000000001
1000000000000000000000000000000000000000000000000000000000000000000010000000001000000000000000000000000000000000000000000000001
1000000000000000000000000000000000000000000000000000000000000000000001000000010000000000000000000000000000000000000000000000001
1000000000000000000000000000000000000000000000000000000000000000000000100000100000000000000000000000000000000000000000000000001
1000000000000000000000000000000000000000000000000000000000000000000000010001000000000000000000000000000000000000000000000000001
1000000000000000000000000000000000000000000000000000000000000000000000001010000000000000000000000000000000000000000000000000001
1000000000000000000000000000000000000000000000000000000000000000000000000100000000000000000000000000000000000000000000000000001
1000000000000000000000000000000000000000000000000000000000000000000000000000000000000000000000000000000000000000000000000000001
1000000000000000000000000000000000000000000000000000000000000000000000000000000000000000000000000000000000000000000000000000001
1000000000000000000000000000000000000000000000000000000000000000000000000000000000000000000000000000000000000000000000000000001
1000000000000000000000000000000000000000000000000000000000000000000000000000000000000000000000000000000000000000000000000000001
1000000000000000000000000000000000000000000000000000000000000000000000000000000000000000000000000000000000000000000000000000001
1000000000000000000000000000000000000000000000000000000000000000000000000000000000000000000000000000000000000000000000000000001
1000000000000000000000000000000000000000000000000000000000000000000000000000000000000000000000000000000000000000000000000000001
1000000000000000000000000000000000000000000000000000000000000000000000000000000000000000000000000000000000000000000000000000001
1000000000000000000000000000000000000000000000000000000000000000000000000000000000000000000000000000000000000000000000000000001
1000000000000000000000000000000000000000000000000000000000000000000000000000000000000000000000000000000000000000000000000000001
1000000000000000000000000000000000000000000000000000000000000000000000000000000000000000000000000000000000000000000000000000001
1000000000000000000000000000000000000000000000000000000000000000000000000000000000000000000000000000000000000000000000000000001
1000000000000000000000000000000000000000000000000000000000000000000000000000000000000000000000000000000000000000000000000000001
1000000000000000000000000000000000000000000000000000000000000000000000000000000000000000000000000000000000000000000000000000001
1000000000000000000000000000000000000000000000000000000000000000000000000000000000000000000000000000000000000000000000000000001
1111111111111111111111111111111111111111111111111111111111111111111111111111111111111111111111111111111111111111111111111111111
